{ "                                                                                "; 
  "                                                                                ";
  "                        ############################    #####################   ";
  "                        ##                        ##    ##                 ##   ";
  "      ####################                        ##    ##                 ##   ";
  "      ##                                          ##    ##                 ##   ";
  "      ##     *     #######                        ##    ##     *           ##   ";
  "      ##           ##   #######              #######    ##                 ##   ";
  "      ##           ##        ##              ##         ##                 ##   ";
  "      ##     I     ##        ########  ########         ##                 ##   ";
  "      ##           ##              ##  ##               ##              I  ##   ";
  "      ###############              ##  ##               ######  #############   ";
  "                                   ##  ##                   ##  ##              ";
  "                                   ##  ##                   ##  ##              ";
  "                  ###################  ###################  ##  ##              ";
  "                  ##                                    ##  ##  ##              ";
  "                  ##                                    ##  ##  ##              ";
  "                  ##                                    ##  ##  ##              ";
  "                  ##                 *                  ######  ##              ";
  "                  ##                                            ##              ";
  "                  ##                                    ##########              ";
  "                  ##    I                               ##                      ";
  "                  ##                                    ##                      ";
  "                  ##                                    ##                      ";
  "                  ###################  #############  ######################    ";
  "                                   ##  ##         ##                      ##    ";
  "                                   ##  ##         ###############         ##    ";
  "                                   ##  ##                      ##         ##    ";
  "                  ###################  ###################     ##         ##    ";
  "     ##########   ##             ##                     ##     ##         ##    ";
  "     ##      ##   ##             ##                     ##     ##         ##    ";
  "     ##      #######             ##                     ##     ##         3#    ";
  "     ##                                                 ##     ##         ##    ";
  "     ##       #############      ##         *           ##     #############    ";
  "     ##           ##     ##      ##                     ##                      ";
  "     ##           ##     ##      ##                     ##                      ";
  "     ##           ##     ##  I   ##                     ##                      ";
  "     ##           ##     ##      ##            I        ##                      ";
  "     ###############     #################################                      ";
  "                                                                                "; }
